BBBBBBBBBBBBB
B...........B
B.BS..GG..SB.
B...........B
B.GG.SS.GG..B
B...........B
B.SS.....SS.B
B.G.........B
B...BB.BB...B
B...........B
B.SB.GG.BS.B
B....B.B....B
B.....E.....B