BBBBBBBBBBBBB
B...........B
BSS.GGG.WSSB
B...........B
BWWW.SS.WWWB
B...........B
BSS.GGG.SSB.
B...........B
BWWW.SS.WWWB
B...........B
BSS.BBB.WSSB
B....S.S....B
B.....E.....B