BBBBBBBBBBBBB
B...........B
B.BB.....BB.B
B...........B
B...BB.BB...B
B...........B
B.BB.....BB.B
B...........B
B...BB.BB...B
B...........B
B.BB.....BB.B
B....B.B....B
B.....E.....B